R,R,O,R,R,R,R,R,R,R
R,R,O,R,R,R,R,R,R,R
R,R,O,R,R,R,R,R,R,R
R,R,O,O,O,O,R,R,R,R
R,R,R,R,R,R,R,R,R,R
R,R,R,R,R,R,R,R,R,R
R,R,R,R,R,R,R,O,R,R
R,R,R,R,R,R,R,O,R,R
R,R,R,R,R,R,R,O,R,R
R,R,R,R,R,R,R,R,R,R